<levelLayout>
0 0 0 0 0 0 0 0 0 0 0 0 0
3 4 4 4 4 4 4 4 4 4 4 4 2 
3 3 4 4 4 4 4 4 4 4 4 4 2
3 3 3 4 4 4 4 4 4 4 4 4 2
3 3 3 3 4 4 4 4 4 4 4 4 2
3 3 3 3 3 1 1 1 1 1 1 1 2
3 3 3 3 1 1 1 1 1 1 1 1 2
3 3 3 1 1 1 1 1 1 1 1 1 2
3 3 1 1 1 1 1 1 1 1 1 1 2
3 1 1 1 1 1 1 1 1 1 1 1 2
2 0 0 0 0 0 0 0 0 0 0 0 2
0 0 0 0 0 0 0 0 0 0 0 0 0
0 0 0 0 0 0 0 0 0 0 0 0 0
<tankLayout>
2 3 3 3 1 2 3 2 1 1 2 2 3 3 1 2 2 3 3 3
