<levelLayout>
0 0 0 0 0 2 0 0 0 0 0 0 0
0 2 0 0 0 2 0 0 0 0 2 0 0
2 2 2 0 0 2 2 0 2 2 2 2 0
0 2 0 0 0 2 2 0 0 2 2 0 0
0 2 0 0 0 2 2 0 0 0 0 0 0
0 0 0 2 0 0 0 0 0 2 2 2 2
0 2 2 2 2 2 0 0 2 2 2 2 2
0 2 2 2 2 2 0 0 2 2 2 0 0
0 2 2 2 2 2 0 0 2 2 2 0 0
0 0 0 0 0 0 0 0 0 2 2 0 0
0 0 0 0 0 0 0 0 0 0 0 0 0
0 0 2 2 0 0 0 0 0 2 2 0 0
0 0 2 2 0 0 0 0 0 2 2 0 0
<tankLayout>
1 1 2 3 1 1 2 2 1 1 2 2 3 3 1 2 2 3 3 3
