<levelLayout>
0 0 0 0 1 0 0 0 0 0 1 0 0
1 0 0 0 1 0 1 0 0 0 1 0 0
2 4 4 4 2 4 2 2 2 4 2 2 2
2 2 4 2 2 4 2 4 4 4 2 4 4
2 4 2 4 2 4 2 2 4 4 2 2 4
2 4 4 4 2 4 2 4 4 4 2 4 4
2 4 4 4 2 4 2 4 4 4 2 4 4
2 4 4 4 2 4 2 4 4 4 2 4 4
2 4 4 4 2 4 2 4 4 4 2 4 4
1 0 0 0 1 0 1 0 0 0 1 0 0
1 0 0 0 1 0 1 0 0 0 1 0 0
1 0 0 0 0 0 0 0 0 0 1 0 0
1 0 0 0 0 0 0 0 0 0 1 0 0
<tankLayout>
2 3 3 3 2 2 3 2 2 3 2 2 2 3 2 2 2 3 3 3
